AND	AH N D
AND(2)	AE N D
ANSWERS	AE N S ER Z
BEST	B EH S T
CANCEL	K AE N S AH L
COMCAST	K AA M K AE S T
COMMAND	K AH M AE N D
CONSUELA	K AH N S W EY L AH
EMAIL	IY M EY L
ENOUGH	IH N AH F
ENOUGH(2)	IY N AH F
HAL	HH AE L
HARD	HH AA R D
HELLO	HH AH L OW
HELLO(2)	HH EH L OW
MANTONIO	M AE N T OW N IY OW
PICKLE	P IH K AH L
QUIET	K W AY AH T
SHUT	SH AH T
SLAP	S L AE P
STOP	S T AA P
THE	DH AH
THE(2)	DH IY
UP	AH P
WORLD	W ER L D
YEEZY	Y IY Z IY
